#ZhuYin	RCD-I-1	FIANL-1
ㄅㄚ	b_a	a
ㄅㄛ	b_u	uo
ㄅㄞ	b_a	ai
ㄅㄟ	b_ee	ei
ㄅㄠ	b_a	au
ㄅㄢ	b_a	an
ㄅㄣ	b_e	en
ㄅㄤ	b_a	ang
ㄅㄥ	b_e	eng
ㄅㄧ	b_i	i
ㄅㄧㄝ	b_i	ie
ㄅㄧㄠ	b_i	iau
ㄅㄧㄢ	b_i	ian
ㄅㄧㄣ	b_i	in
ㄅㄧㄥ	b_i	ing
ㄅㄛ	b_o	o
ㄅㄨ	b_u	u
ㄆㄚ	p_a	a
ㄆㄛ	p_u	uo
ㄆㄞ	p_a	ai
ㄆㄟ	p_ee	ei
ㄆㄠ	p_a	au
ㄆㄡ	p_o	ou
ㄆㄢ	p_a	an
ㄆㄣ	p_e	en
ㄆㄤ	p_a	ang
ㄆㄥ	p_e	eng
ㄆㄧ	p_i	i
ㄆㄧㄝ	p_i	ie
ㄆㄧㄠ	p_i	iau
ㄆㄧㄢ	p_i	ian
ㄆㄧㄣ	p_i	in
ㄆㄧㄥ	p_i	ing
ㄆㄨ	p_u	u
ㄇㄚ	m_a	a
ㄇㄛ	m_u	uo
ㄇㄞ	m_a	ai
ㄇㄟ	m_ee	ei
ㄇㄠ	m_a	au
ㄇㄛ	m_o	o
ㄇㄡ	m_o	ou
ㄇㄢ	m_a	an
ㄇㄣ	m_e	en
ㄇㄤ	m_a	ang
ㄇㄥ	m_e	eng
ㄇㄧ	m_i	i
ㄇㄧㄝ	m_i	ie
ㄇㄧㄠ	m_i	iau
ㄇㄧㄡ	m_i	iou
ㄇㄧㄢ	m_i	ian
ㄇㄧㄣ	m_i	in
ㄇㄧㄥ	m_i	ing
ㄇㄨ	m_u	u
ㄈㄚ	f_a	a
ㄈㄛ	f_u	uo
ㄈㄟ	f_ee	ei
ㄈㄡ	f_o	ou
ㄈㄢ	f_a	an
ㄈㄣ	f_e	en
ㄈㄤ	f_a	ang
ㄈㄥ	f_e	eng
ㄈㄨ	f_u	u
ㄉㄚ	d_a	a
ㄉㄜ	d_e	e
ㄉㄞ	d_a	ai
ㄉㄟ	d_ee	ei
ㄉㄠ	d_a	au
ㄉㄡ	d_o	ou
ㄉㄢ	d_a	an
ㄉㄤ	d_a	ang
ㄉㄥ	d_e	eng
ㄉㄧ	d_i	i
ㄉㄧㄝ	d_i	ie
ㄉㄧㄠ	d_i	iau
ㄉㄧㄡ	d_i	iou
ㄉㄧㄢ	d_i	ian
ㄉㄧㄥ	d_i	ing
ㄉㄨ	d_u	u
ㄉㄨㄛ	d_u	uo
ㄉㄨㄟ	d_u	uei
ㄉㄨㄢ	d_u	uan
ㄉㄨㄣ	d_u	uen
ㄉㄨㄥ	d_u	ueng
ㄊㄚ	t_a	a
ㄊㄜ	t_e	e
ㄊㄞ	t_a	ai
ㄊㄠ	t_a	au
ㄊㄡ	t_o	ou
ㄊㄢ	t_a	an
ㄊㄤ	t_a	ang
ㄊㄥ	t_e	eng
ㄊㄧ	t_i	i
ㄊㄧㄝ	t_i	ie
ㄊㄧㄠ	t_i	iau
ㄊㄧㄢ	t_i	ian
ㄊㄧㄥ	t_i	ing
ㄊㄨ	t_u	u
ㄊㄨㄛ	t_u	uo
ㄊㄨㄟ	t_u	uei
ㄊㄨㄢ	t_u	uan
ㄊㄨㄣ	t_u	uen
ㄊㄨㄥ	t_u	ueng
ㄋㄚ	n_a	a
ㄋㄜ	n_e	e
ㄋㄞ	n_a	ai
ㄋㄟ	n_ee	ei
ㄋㄠ	n_a	au
ㄋㄡ	n_o	ou
ㄋㄢ	n_a	an
ㄋㄣ	n_e	en
ㄋㄤ	n_a	ang
ㄋㄥ	n_e	eng
ㄋㄧ	n_i	i
ㄋㄧㄝ	n_i	ie
ㄋㄧㄠ	n_i	iau
ㄋㄧㄡ	n_i	iou
ㄋㄧㄢ	n_i	ian
ㄋㄧㄣ	n_i	in
ㄋㄧㄤ	n_i	iang
ㄋㄧㄥ	n_i	ing
ㄋㄨ	n_u	u
ㄋㄨㄛ	n_u	uo
ㄋㄨㄢ	n_u	uan
ㄋㄨㄥ	n_u	ueng
ㄋㄩ	n_iu	iu
ㄋㄩㄝ	n_iu	iue
ㄌㄚ	l_a	a
ㄌㄜ	l_e	e
ㄌㄞ	l_a	ai
ㄌㄟ	l_ee	ei
ㄌㄠ	l_a	au
ㄌㄡ	l_o	ou
ㄌㄢ	l_a	an
ㄌㄤ	l_a	ang
ㄌㄥ	l_e	eng
ㄌㄧ	l_i	i
ㄌㄧㄚ	l_i	ia
ㄌㄧㄝ	l_i	ie
ㄌㄧㄠ	l_i	iau
ㄌㄧㄡ	l_i	iou
ㄌㄧㄢ	l_i	ian
ㄌㄧㄣ	l_i	in
ㄌㄧㄤ	l_i	iang
ㄌㄧㄥ	l_i	ing
ㄌㄨ	l_u	u
ㄌㄨㄛ	l_u	uo
ㄌㄨㄢ	l_u	uan
ㄌㄨㄣ	l_u	uen
ㄌㄨㄥ	l_u	ueng
ㄌㄩ	l_iu	iu
ㄌㄩㄝ	l_iu	iue
ㄌㄩㄢ	l_iu	iuan
ㄍㄚ	g_a	a
ㄍㄜ	g_e	e
ㄍㄞ	g_a	ai
ㄍㄟ	g_ee	ei
ㄍㄠ	g_a	au
ㄍㄡ	g_o	ou
ㄍㄢ	g_a	an
ㄍㄣ	g_e	en
ㄍㄤ	g_a	ang
ㄍㄥ	g_e	eng
ㄍㄨ	g_u	u
ㄍㄨㄚ	g_u	ua
ㄍㄨㄛ	g_u	uo
ㄍㄨㄞ	g_u	uai
ㄍㄨㄟ	g_u	uei
ㄍㄨㄢ	g_u	uan
ㄍㄨㄣ	g_u	uen
ㄍㄨㄤ	g_u	uang
ㄍㄨㄥ	g_u	ueng
ㄎㄚ	k_a	a
ㄎㄜ	k_e	e
ㄎㄞ	k_a	ai
ㄎㄠ	k_a	au
ㄎㄡ	k_o	ou
ㄎㄢ	k_a	an
ㄎㄣ	k_e	en
ㄎㄤ	k_a	ang
ㄎㄥ	k_e	eng
ㄎㄨ	k_u	u
ㄎㄨㄚ	k_u	ua
ㄎㄨㄛ	k_u	uo
ㄎㄨㄞ	k_u	uai
ㄎㄨㄟ	k_u	uei
ㄎㄨㄢ	k_u	uan
ㄎㄨㄣ	k_u	uen
ㄎㄨㄤ	k_u	uang
ㄎㄨㄥ	k_u	ueng
ㄏㄚ	h_a	a
ㄏㄜ	h_e	e
ㄏㄞ	h_a	ai
ㄏㄟ	h_ee	ei
ㄏㄠ	h_a	au
ㄏㄡ	h_o	ou
ㄏㄢ	h_a	an
ㄏㄣ	h_e	en
ㄏㄤ	h_a	ang
ㄏㄥ	h_e	eng
ㄏㄨ	h_u	u
ㄏㄨㄚ	h_u	ua
ㄏㄨㄛ	h_u	uo
ㄏㄨㄞ	h_u	uai
ㄏㄨㄟ	h_u	uei
ㄏㄨㄢ	h_u	uan
ㄏㄨㄣ	h_u	uen
ㄏㄨㄤ	h_u	uang
ㄏㄨㄥ	h_u	ueng
ㄐㄧ	ji_i	i
ㄐㄧㄚ	ji_i	ia
ㄐㄧㄝ	ji_i	ie
ㄐㄧㄠ	ji_i	iau
ㄐㄧㄡ	ji_i	iou
ㄐㄧㄢ	ji_i	ian
ㄐㄧㄣ	ji_i	in
ㄐㄧㄤ	ji_i	iang
ㄐㄧㄥ	ji_i	ing
ㄐㄩ	ji_iu	iu
ㄐㄩㄝ	ji_iu	iue
ㄐㄩㄢ	ji_iu	iuan
ㄐㄩㄣ	ji_iu	iun
ㄐㄩㄥ	ji_iu	iung
ㄑㄧ	chi_i	i
ㄑㄧㄚ	chi_i	ia
ㄑㄧㄝ	chi_i	ie
ㄑㄧㄠ	chi_i	iau
ㄑㄧㄡ	chi_i	iou
ㄑㄧㄢ	chi_i	ian
ㄑㄧㄣ	chi_i	in
ㄑㄧㄤ	chi_i	iang
ㄑㄧㄥ	chi_i	ing
ㄑㄩ	chi_iu	iu
ㄑㄩㄝ	chi_iu	iue
ㄑㄩㄢ	chi_iu	iuan
ㄑㄩㄣ	chi_iu	iun
ㄑㄩㄥ	chi_iu	iung
ㄒㄧ	shi_i	i
ㄒㄧㄚ	shi_i	ia
ㄒㄧㄝ	shi_i	ie
ㄒㄧㄠ	shi_i	iau
ㄒㄧㄡ	shi_i	iou
ㄒㄧㄢ	shi_i	ian
ㄒㄧㄣ	shi_i	in
ㄒㄧㄤ	shi_i	iang
ㄒㄧㄥ	shi_i	ing
ㄒㄩ	shi_iu	iu
ㄒㄩㄝ	shi_iu	iue
ㄒㄩㄢ	shi_iu	iuan
ㄒㄩㄣ	shi_iu	iun
ㄒㄩㄥ	shi_iu	iung
ㄓ	j_empt	empt1
ㄓㄚ	j_a	a
ㄓㄜ	j_e	e
ㄓㄞ	j_a	ai
ㄓㄠ	j_a	au
ㄓㄡ	j_o	ou
ㄓㄢ	j_a	an
ㄓㄣ	j_e	en
ㄓㄤ	j_a	ang
ㄓㄥ	j_e	eng
ㄓㄨ	j_u	u
ㄓㄨㄚ	j_u	ua
ㄓㄨㄛ	j_u	uo
ㄓㄨㄞ	j_u	uai
ㄓㄨㄟ	j_u	uei
ㄓㄨㄢ	j_u	uan
ㄓㄨㄣ	j_u	uen
ㄓㄨㄤ	j_u	uang
ㄓㄨㄥ	j_u	ueng
ㄔ	ch_empt	empt1
ㄔㄚ	ch_a	a
ㄔㄜ	ch_e	e
ㄔㄞ	ch_a	ai
ㄔㄠ	ch_a	au
ㄔㄡ	ch_o	ou
ㄔㄢ	ch_a	an
ㄔㄣ	ch_e	en
ㄔㄤ	ch_a	ang
ㄔㄥ	ch_e	eng
ㄔㄨ	ch_u	u
ㄔㄨㄚ	ch_u	ua
ㄔㄨㄛ	ch_u	uo
ㄔㄨㄞ	ch_u	uai
ㄔㄨㄟ	ch_u	uei
ㄔㄨㄢ	ch_u	uan
ㄔㄨㄣ	ch_u	uen
ㄔㄨㄤ	ch_u	uang
ㄔㄨㄥ	ch_u	ueng
ㄕ	sh_empt	empt1
ㄕㄚ	sh_a	a
ㄕㄜ	sh_e	e
ㄕㄞ	sh_a	ai
ㄕㄟ	sh_ee	ei
ㄕㄠ	sh_a	au
ㄕㄡ	sh_o	ou
ㄕㄢ	sh_a	an
ㄕㄣ	sh_e	en
ㄕㄤ	sh_a	ang
ㄕㄥ	sh_e	eng
ㄕㄨ	sh_u	u
ㄕㄨㄚ	sh_u	ua
ㄕㄨㄛ	sh_u	uo
ㄕㄨㄞ	sh_u	uai
ㄕㄨㄟ	sh_u	uei
ㄕㄨㄢ	sh_u	uan
ㄕㄨㄣ	sh_u	uen
ㄕㄨㄤ	sh_u	uang
ㄖ	r_empt	empt1
ㄖㄜ	r_e	e
ㄖㄠ	r_a	au
ㄖㄡ	r_o	ou
ㄖㄢ	r_a	an
ㄖㄣ	r_e	en
ㄖㄤ	r_a	ang
ㄖㄥ	r_e	eng
ㄖㄨ	r_u	u
ㄖㄨㄛ	r_u	uo
ㄖㄨㄟ	r_u	uei
ㄖㄨㄢ	r_u	uan
ㄖㄨㄣ	r_u	uen
ㄖㄨㄥ	r_u	ueng
ㄗ	tz_empt	empt2
ㄗㄚ	tz_a	a
ㄗㄜ	tz_e	e
ㄗㄞ	tz_a	ai
ㄗㄟ	tz_ee	ei
ㄗㄠ	tz_a	au
ㄗㄡ	tz_o	ou
ㄗㄢ	tz_a	an
ㄗㄣ	tz_e	en
ㄗㄤ	tz_a	ang
ㄗㄥ	tz_e	eng
ㄗㄨ	tz_u	u
ㄗㄨㄛ	tz_u	uo
ㄗㄨㄟ	tz_u	uei
ㄗㄨㄢ	tz_u	uan
ㄗㄨㄣ	tz_u	uen
ㄗㄨㄥ	tz_u	ueng
ㄘ	ts_empt	empt2
ㄘㄚ	ts_a	a
ㄘㄜ	ts_e	e
ㄘㄞ	ts_a	ai
ㄘㄠ	ts_a	au
ㄘㄡ	ts_o	ou
ㄘㄢ	ts_a	an
ㄘㄣ	ts_e	en
ㄘㄤ	ts_a	ang
ㄘㄥ	ts_e	eng
ㄘㄨ	ts_u	u
ㄘㄨㄛ	ts_u	uo
ㄘㄨㄟ	ts_u	uei
ㄘㄨㄢ	ts_u	uan
ㄘㄨㄣ	ts_u	uen
ㄘㄨㄥ	ts_u	ueng
ㄙ	s_empt	empt2
ㄙㄚ	s_a	a
ㄙㄜ	s_e	e
ㄙㄞ	s_a	ai
ㄙㄠ	s_a	au
ㄙㄡ	s_o	ou
ㄙㄢ	s_a	an
ㄙㄣ	s_e	en
ㄙㄤ	s_a	ang
ㄙㄥ	s_e	eng
ㄙㄨ	s_u	u
ㄙㄨㄛ	s_u	uo
ㄙㄨㄟ	s_u	uei
ㄙㄨㄢ	s_u	uan
ㄙㄨㄣ	s_u	uen
ㄙㄨㄥ	s_u	ueng
ㄚ	sic_a	a
ㄛ	sic_o	o
ㄜ	sic_e	e
ㄞ	sic_a	ai
ㄠ	sic_a	au
ㄡ	sic_o	ou
ㄢ	sic_a	an
ㄣ	sic_e	en
ㄤ	sic_a	ang
ㄦ	sic_e	er
ㄧ	sic_i	i
ㄧㄚ	sic_i	ia
ㄧㄝ	sic_i	ie
ㄧㄞ	sic_i	iai
ㄧㄠ	sic_i	iau
ㄧㄡ	sic_i	iou
ㄧㄢ	sic_i	ian
ㄧㄣ	sic_i	in
ㄧㄤ	sic_i	iang
ㄧㄥ	sic_i	ing
ㄨ	sic_u	u
ㄨㄚ	sic_u	ua
ㄨㄛ	sic_u	uo
ㄨㄞ	sic_u	uai
ㄨㄟ	sic_u	uei
ㄨㄢ	sic_u	uan
ㄨㄣ	sic_u	uen
ㄨㄤ	sic_u	uang
ㄨㄥ	sic_u	ueng
ㄩ	sic_iu	iu
ㄩㄝ	sic_iu	iue
ㄩㄢ	sic_iu	iuan
ㄩㄣ	sic_iu	iun
ㄩㄥ	sic_iu	iung
